R 500 500

NO ./textures/block1.xpm

SO ./textures/brick.xpm

WE ./textures/block3.xpm

EA ./textures/block4.xpm

S ./textures/sprite.xpm

F ./textures/grass.xpm

C ./textures/skybox.xpm

111111111111
100000000001
100000000001
100000000001
100000000001
100002000001
100000000001
10000N000001
100000000001
100000000001
100000000001
111111111111
