R 500 500

NO ./textures/block1.xpm

SO ./textures/brick.xpm

WE ./textures/block3.xpm

EA ./textures/block4.xpm

S ./textures/sprite.xpm

S1 ./textures/block3.xpm

S2 ./textures/goomba1.xpm

//F 0 0 255
F ./textures/grass.xpm

//C 0 255 0
C ./textures/skybox.xpm



                     1111111111111111111111
                     1000000000000000000001
11111111111111111111 1020000000000000000001
10000000000000000001 1000000000000000000001
10E00000000000000001 1111111111111111111001
10000000000000000001                   1001
11111111111111110001111111111111111    1001
               10400000000000000001111 1001
               10000000000000000000001 1001          
               10000000000000000001101 1441
               11111111111111111111141 1001
                                   101 1001
11111111111111111111111111111111111101 1001                      
10000000000000000000000004000000000001 1001
10000000000000111111111111111111111111 1001
100011111110001                        1001
100010000010001                     1111001                
100010020010001                     1000001
100010000010001                     1000001
100011101110001                     1001111
1000000000000011111111111111111111111001
1000000000000000000000004000000000000001
1000000000000000000000000000004000000001
1111111111111111111111111111111111110201
                                   11111
