R 500 500

NO ./path_to_the_north_texture

SO ./path_to_the_south_texture

WE ./path_to_the_west_texture

EA ./path_to_the_east_texture

S ./path_to_the_sprite_texture

F 255,255,255

C 0,0,0

111111111111111
100000000000001
100010000000001
100000001000001
100000000000001
100000000000001
100000000000001
100010000001001
100000000000001
100000000000001
100000000000001
100010000000001
100000001000001
100000000000001
111111111111111
