R 500 500

NO ./textures/block1.xpm

SO ./textures/block2.xpm

WE ./textures/block3.xpm

EA ./textures/block4.xpm

S ./texture_sprite

F ./textures/grass.xpm

C ./textures/skybox.xpm

100000001111111111111111111111111
100000001000000000110000000000001
100000001011000001110000002000001
100000001001000000000000000000001
111111111011000001110000000000001
100000000011000001110111111111111
111101111111110111000000100010000
111101111111110111010100100010000
110000001101010111000000000010000
100020000000000011000000100010000
100000000000000011010100100010000
11000001110101011111011110N011100
111101110111010101011110100010000
111111110111111101111111111110000
