R 500 500

NO ./textures/block1.xpm

SO ./textures/brick.xpm

WE ./textures/block3.xpm

EA ./textures/block4.xpm

S ./textures/sprite.xpm

S1 ./textures/block3.xpm

S2 ./textures/goomba1.xpm

F ./textures/grass.xpm

C ./textures/skybox.xpm

1111111111110
1040000000010
1020000002010
1040000000010
1400000400010
1000000000010
1000000000010
10000N0000010
1000000000010
1020000003010
1000000000010
1111111111110
