R 500 500

NO ./textures/block1.xpm

SO ./textures/block2.xpm

WE ./textures/block3.xpm

EA ./textures/block4.xpm

S ./texture_sprite

F ./textures/grass.xpm

C ./textures/skybox.xpm

111111111111111
100000000000001
111111111111111
100000010000001
100000000000001
100000000000001
100000000000001
100000000000001
100000000000001
1000000N0000001
100000000000001
100000000000001
100000000001001
100000000001001
100000000001001
111111111111111
