1111111111111111111111
100000000000000000N001
1011111111111111111111
101
101 111111111111111111
101 100000000000000001
101 101111111111111101
101 101000000000000101
101 101111111111100101
101 100000000000000101
101 111111111111111101
101                101
1011111111111111111101
1000000000000000000001
1111111111111111111111
