1111111111111111111111
100000000000000000N001
1011111111111111111111
1010000000000000000000
1010111111111111111111
1010100000000000000001
1010101111111111111101
1010101000000000000101
1010101111111111100101
1010100000000000000101
1010111111111111111101
1010000000000000000101
1011111111111111111101
1000000000000000000001
1111111111111111111111
